4 5 4 5 6
4 4 6 7 5
4 6 5 6 4
4 4 5 4 4
4 5 6 4 4